16 16
4 13
1 1 1 1 1 1 1 1 1 1 1 1 1 1 1 1
1 1 1 1 1 1 1 1 1 1 1 1 7 7 1 1
1 1 1 1 1 1 1 1 3 0 1 1 0 3 1 1
1 1 1 1 1 1 1 1 0 0 1 1 0 0 1 1
1 7 0 0 0 0 0 0 0 0 0 0 0 0 1 1
1 7 0 0 0 0 0 0 0 0 0 0 0 0 1 1
1 1 1 1 0 0 1 1 1 1 1 1 0 0 1 1
1 1 1 1 0 0 1 1 1 1 1 1 0 0 1 1
1 1 1 1 0 0 0 0 1 1 1 1 0 0 1 1
1 1 1 1 0 0 0 2 1 1 1 1 0 0 1 1
1 1 1 1 1 1 1 1 1 1 1 1 0 0 1 1
1 1 1 1 1 1 1 1 1 1 1 1 0 0 1 1
1 1 0 0 0 0 0 0 0 0 0 0 0 0 1 1
1 1 0 0 0 0 0 0 0 0 0 0 0 0 1 1
1 1 1 1 1 1 1 1 1 1 1 1 1 1 1 1
1 1 1 1 1 1 1 1 1 1 1 1 1 1 1 1
0