16 16
8 13
1 1 1 1 1 1 1 1 1 1 1 1 1 1 1 1
1 1 7 1 7 1 7 1 1 7 1 7 1 7 1 1
1 7 0 0 0 0 0 0 4 0 4 0 0 0 7 1
1 1 0 3 0 0 0 0 0 0 0 0 2 0 1 1
1 7 0 0 0 0 0 0 0 0 0 0 0 0 7 1
1 1 0 0 0 0 0 0 0 0 0 0 0 0 1 1
1 7 0 0 4 0 0 4 0 0 3 0 0 0 7 1
1 1 0 0 4 0 0 4 0 0 0 0 0 0 1 1
1 7 0 0 0 0 0 0 0 4 0 0 4 0 7 1
1 1 0 0 0 0 0 0 0 4 0 0 4 0 1 1
1 7 0 0 0 4 4 1 1 1 4 4 3 0 7 1
1 1 0 0 0 4 0 0 0 0 0 4 0 0 1 1
1 7 0 0 0 1 0 0 0 0 0 1 0 0 7 1
1 1 0 0 0 1 0 0 0 0 0 1 0 0 1 1
1 1 1 1 1 1 1 1 1 1 1 1 1 1 1 1
1 1 1 1 1 1 1 1 1 1 1 1 1 1 1 1
0